0;40;30;
0;180;180;
0;8;
25;50;
0;0;0;0;
T T T T T T T T T T T T T T T T T T T T T T T T T T T T T T T T T T T T T T T T
T P - - - - - - - - - - - - - - - - - - - - - W W W W W W W W W W W W W W W * T
T W W W W W W @ TE1 @ W W W W D D D D D D D D D D D D D D D W D D D D @ @ D D D T
T D D D D D D D D D D D D D D RK - - - - - - - - - D D D D W D D D D D D D D D T
T D D D D D D D D M D D D D D D D D D D D D D D D D D D D W D D D D D D D D D T
T D D D D D D D D - - - - BR - - D D D D D D D D D @ @ D D RD D D D D D D D D D T
T * D D D D D D D - - - - - - - D D D D D D D D D D D D D W D D D D D D D D D T
T D D D D D D D D D D D D D D D D D D D D D D D D D D D D W D D D D D D D D D T
T D D D D D D D D D D D D D D D D - - - - - - - - - - - - W - - D D D D * D D T
T D D D D D D D D D D D D D D D D D D D D D D D D D D D D W D D D D D D D D D T
T @ @ @ @ @ @ @ @ @ @ D D D D D D D D @ @ @ D D D D D D D W W W W W W W W W W T
T D D D D D D D D D D D D * D D @ @ D D D D D D D D D @ @ D D D D D @ @ D D YK T
T D D D D D @ D D D D D - - - D D D D D W W W W W W D D D D D D D D D D D D D T
T - - - - D M D D D D D D D D D D D D D W D GK * D W D D D D D @ D D D D D @ @ T
T D D D D D D D @ @ @ D D D D D D @ D D W D D D D W D D @ D D D @ D D D D D D T
T D D D D D D D D D D D D D D D D D D D W W W YD W W D D D D D D D D D D D D D T
T D D D D D D D D D D D D D D D D D D D D D D @ D D D D D D D D D D D D D D D T
T D D A1 D D D D D D D D D D D D D D D D D D D D D D D D D D D D D D D D D D D T
T W W W W W W W W W W W W W W GD W W W W W W W W W W W W W W W W W W W W W W W T
T D D D D D D D D D D D D D D D D D D D D D D D @ @ D D @ D D @ @ D D D D D D T
T D D D @ @ D D - - - - - - - D D D D D @ @ D D D D @ D D D @ @ @ D D D D D @ T
T D D @ D D D D D D D D D D D D @ @ D * D D D D D D D D D D D D D D D @ D D D T
T D D @ D D D D D D D - - - F D D D D D D D D D D @ @ @ D D D D D D D D D D D T
T * D D D D D D - - - - D D D D D D D D D D D D D D D D D D D D D D D D D D D T
T M D D D D D D D D D D D D - - - - - FL - - - D D D D D D D D D D @ @ @ @ @ @ T
T D D D D D D D D D D D D D - W W W W W W W - D D D D D D D D @ @ D D D D D D T
T D D D D @ @ @ D D D D D D - D D D BK * D W - D D D D D D D D D D D D D D D D T
T D D D @ D D D D D D D D D - W W W W W W W - D D D @ @ D D @ @ D D D W W W W T
T D D D D D D D D D D D D D - - - - - - - TE1 - D D D D D D @ D D D @ D BD D D E T
T T T T T T T T T T T T T T T T T T T T T T T T T T T T T T T T T T T T T T T T