3;13;11;
0;180;180;
0;1;
3;4;
0;0;0;0;
T T T T T T T T T T T T T
T @ - - - - @ - @ - - - T
T D D - - D D D D D * E T
T - - P - - - - - W W - T
T - - - - - - - - - - - T
T D D D D D D D D D D D T
T M - - - - - - - - - - T
T - - - - - F - - - - - T
T - - - - - - - - - - - T
T FR BR - - - - - - - - - T
T T T T T T T T T T T T T