1;8;9;
0;180;180;
0;1;
3;4;
0;0;0;0;
T T T T T T T T
T P - - - - - T
T - D D D D - T
T - D D D D - T
T - D D D D - T
T - - - F - - T
T - - - * - - T
T T T T E T T T
T T T T T T T T