2;40;30;
0;180;180;
0;11;
2;7;
0;0;0;0;
T T T T T T T T T T T T T T T T T T T T T T T T T T T T T T T T T T T T T T T T
T P - - - - W D D D - - - D D D D D D D D D D @ D D - - - D D D D D D D D T A2 T
T - - - D D D D D D D D D D D D D D D D D D D D D D D D D D D D D D D D D D D T
T D D D D D D D D D D D D D D D D D D D D D D M D D D D * D D D D D D D D D D T
T @ @ @ @ D D D D - - - - - - - D GD D D D D D D D D D D D D D D D D D D D D D T
T D D D D D D D D - W W W W W - D D D D D D D D D @ @ D D D D D D D D D D D D T
T D YD D D D D D D - W D D D W - D D D D @ D D D D * D D D D D D D * D D D D D T
T D D D @ D D D @ - W D GK D W - D D D D @ @ D D D D D D D D D D D D D D D D D T
T D @ D D D D @ D - W D D D W - D D D @ D D D D D D * D D D D D D M D D D D D T
T D D D D D D D D - W W D W W - D D D * D D D D D D D D D D D D D D D D D D D T
T D D D D D D D D - - - - - FR - D D D D D D D D D @ @ @ D D D * - - - - - - D T
T D D D D D D D D D D D D D D D D D D D D D D D D D * D D D D D D D D D D D D T
T D D D D D D D D D * - - @ @ - - D D D D D D @ D @ D D D D D D D D D D D D D T
T D D A1 D D D D D D D D D RK D D D - - - - - D D D D D D D D D - - - - - BR - D T
T D D D D D D D D D D D D - - D D D - - - - D D D D D D D D D - D D D D D D D T
T D D D D D D - - D D D D D D D D D D D D D D D D D D D D D D D D D D D D D D T
T D D D D D D D D D @ D D D @ D D D @ D D D @ @ @ D D D D D D D D D D D D D D T
T D D D D D D D D D D D D D D D D D D D D D M D D D D D D D D D D D D D D D D T
T @ @ @ D D D D D D - - - - - - - RD D D D D D D D D D D D D D D D D D D D D D T
T D D D D D D D D D D D D D D D D D D D D D D D D D D D D D D D D D D D D D D T
T D * D D D D D D D - - D D D W W W W W W W W W W W W W W W W W W W W W W W W T
T D D D D D D D D D D D D D D D @ @ @ @ @ @ @ @ D D D D D D W W D D D D D D D T
T D M D D D D D D D D D D D D D * D D D D D D D D D - - - - - - D D D D D D D T
T D D D D D D @ @ D D D D D D D D D @ D D D D D D D D D D D D D D YK D D D D D T
T D D D D D D D D D D D D W W W W W W D D D D D D D D D D D D D D D D D D D D T
T D D D D D D D D D D D D W * D D * W D D D D D D D D D D @ @ @ D D D D D D D T
T D D D D D D D D D D D D W D D BD D W D D BK D D D D D D D D D D D D D D D D D T
T @ @ D @ D @ D D D D D D D D D D E W D D D D D D D D D D D D D D D D D D D D T
T D D D D D D D D D D D D W W W W W W D D D D D D D D D * D D D D D D D D D D T
T T T T T T T T T T T T T T T T T T T T T T T T T T T T T T T T T T T T T T T T