3;40;30;
0;200;200
0;11;
2;7;
0;0;0;0;
T T T T T T T T T T T T T T T T T T T T T T T T T T T T T T T T T T T T T T T T
T P D D D D W D D D D D D D D D @ D D D D D D D D D D D D D - - - D * D @ D D T
T D D D D D W D @ D D D D D D D @ D D D D D D D D D D D D D - F - D D D D D D T
T D D D D D W D D D D - - - - - * - - - - - D D D D D D D D - - - D D GD D D D T
T W W W W D W D D D D D D D D - - - D D D D D D D D @ @ @ @ - - - D D D D D D T
T @ @ @ D D D D D D D D @ @ - - - - - @ @ D D D D D D D D M D D - - - - - - - T
T M @ @ D D D GD D D D D D D D D - - - - - - - - - - - D D D D D D D D D D D D T
T D D D D D D D D D BD - - - - - - D D D D D D D D D D D D D D D D D D D D D D T
T D D D D D D D D D D D D D D D D D D D D * @ @ D D D D D D D D D D D D D D D T
T D D D D D D D D @ @ @ @ @ D D D D D D D D @ D D D D W W W W W D D D D D D D T
T D D D D D D D D @ @ @ @ @ D D D D - - - - D D D D @ W D D D D D D D D D D D T
T D @ @ D D D D D D D D @ @ D D D D D D D D D D D D D W D D D D D RK D D @ @ @ T
T D D D D D D D D @ @ D D D D - - - - - - - - - - - D W D D D D D D D D D D D T
T D D D D D D D D @ D D D D D D D D - - - - * - - - - - - D D D D D D D D * D T
T - - - - D D D D D D D D D D D D D D D D @ @ @ D D D W D D D D - - - D D D D T
T - - - @ D D D D * - - - - - YK - - - D D D D D D D D W W W W W W W W W W D D T
T FN D D D D D D D D D D D D - - - - - - - - - - D D D D D D D D D D D D D D D T
T D D D D D D D D @ @ * D D D D - - - - - - - - D D D D D D D D @ @ @ D D D D T
T T T T T T T T T T T T T T T T T T - - T T T T T T T T D T T T T T T T T T T T
T D D D D D D D D D D D D D D D D D D D D D D D D D D D D D D D D D D D D D D T
T D D D D @ @ @ D D D D D D D D @ @ @ @ D D D D D D D D @ @ @ D D D D D D D D T
T D D D D D D D D RD D D D D D D D D D D D D - - - - - D M D D D D D D D D D D T
T D D D D * W W W W W W D D D D D D D D D D D D - - - D D D D D D D D GK D D D T
T @ @ @ - - - - - - - - - D D D D D D D D D D D D - - - - - - @ @ @ D D D D D T
T D D D D @ @ @ - - - - - D D D D * D D D D D D D D D D D D D D D D D D D D D T
T D D D YD D D D D D D D D @ @ @ @ D D D D D D D D BK D D D D D D D D - - - - - T
T D D D D D D D @ D D D D D * D D - - - - - - - - - - - - - - - - - D D D D D T
T D D D D D D D D @ D D D D D D D D D D D - - - - - D D D D @ @ @ @ @ D D D D T
T E - - - - - - - D D D D * D D D D D D D D D D D D - - - D D D D D D D D D D T
T T T T T T T T T T T T T T T T T T T T T T T T T T T T T T T T T T T T T T T T