4;10;10;
0;200;2000;
0;11;
2;7;
0;0;0;0;
- - - - - - - - - -
- - - - - - - - - -
- - - - - W W W - -
- - - - - - BL W - -
- - - W - - - W - -
- - W - W - - - - -
- - W - W - - - - P
- - W W W - - - - -
- - - FR - - - BL W -
- - - - - - - - - -