7 15
180 10 5 12   
120 0 0 
P - - - - RD - W W W W W W W W
- D * - - BN - - - @ @ W - * E
W W - - - - - T T T T W - - W
W @ D W W - FS - D D - RK D - W
W - * * D M D @ - - * GD D - W
W - - - GK - - - - - - - - - W
W W W W W W W W W W W W W W W
